WWWWWWWWWWWWWWWWWWWWWWWWWWWW
WCCCACCCCCCCCWWCCCCCCCCCCCCW
WCWWWWCWWWWWCWWCWWWWWCWWWWCW
WPWWWWCWWWWWCWWCWWWWWCWWWWPW
WCWWWWCWWWWWCWWCWWWWWCWWWWCW
WCCCCCCCCCCCCCCCCCCCCCCCCCCW
WCWWWWCWWCWWWWWWWWCWWCWWWWCW
WCWWWWCWWCWWWWWWWWCWWCWWWWCW
WCCCCCCWWCCCCWWCCCCWWCCCCCCW
WWWWWWCWWWWWEWWEWWWWWCWWWWWW
EEEEEWCWWWWWEWWEWWWWWCWEEEEE
EEEEEWCWWWEEEEEEEEWWWCWEEEEE
EEEEEWCWWWEWEWWEWEWWWCWEEEEE
EEEEEWCWWWEWEWWEWEWWWCWEEEEE
EEEEEWCWWWEWSSSSWEWWWCWEEEEE
EEEEEWCWWWEWWWWWWEWWWCWEEEEE
EEEEEWCWWWEEEEEEEEWWWCWEEEEE
WWWWWWCWWWEWWWWWWEWWWCWWWWWW
WCCCCCCCCCCCCWWCCCCCCCCCCCCW
WCWWWWCWWWWWCWWCWWWWWCWWWWCW
WCWWWWCWWWWWCWWCWWWWWCWWWWCW
WPCCWWCWWWWWCWWCWWWWWCWWCCPW
WWWCWWCCCCCCCCCCCCCCCCWWCWWW
WWWCWWCWWCWWWWWWWWCWWCWWCWWW
WWWCWWCWWCWWWWWWWWCWWCWWCWWW
WCCCCCCWWCCCCWWCCCCWWCCCCCCW
WCWWWWWWWWWWCWWCWWWWWWWWWWCW
WCWWWWWWWWWWCWWCWWWWWWWWWWCW
WCCCCCCCCCCCCCCCCCCCCCCCCCCW
WWWWWWWWWWWWWWWWWWWWWWWWWWWW