WWWWWWWWWWWWWWWWWWWWWWWWWWWW
WCCCACCCCCCCCWWCCCCCCCCCCCCW
WCWWWWCWWWWWCWWCWWWWWCWWWWCW
WPWWWWCWWWWWCWWCWWWWWCWWWWPW
WCWWWWCWWWWWCWWCWWWWWCWWWWCW
WCCCCCCCCCCCCCCCCCCCCCCCCCCW
WCWWWWCWWCWWWWWWWWCWWCWWWWCW
WCWWWWCWWCWWWWWWWWCWWCWWWWCW
WCCCCCCWWCCCCWWCCCCWWCCCCCCW
WWWWWWCWWWWWEWWEWWWWWCWWWWWW
EEEEEWCWWWWWEWWEWWWWWCWEEEEE
EEEEEWCWWEEEEEEEEEEWWCWEEEEE
WWWWWWCWWWEWSSSSWEWWWCWWWWWW